11111111111111111111
1000001w000000000001
10101010101010101011
11011101110000000001
1000010001000x010011
11111111111111111111