11111111111111111111
1000000w000000000001
10101010101010101011
11011101110000000001
1000010001000001x011
11111111111111111111